11 11
8 8 8 8 8 8 8 8 8 8 8
8 0 0 0 0 0 0 0 0 0 8
8 0 8 8 0 0 0 0 0 0 8
8 0 7 8 0 0 0 0 0 0 8
8 8 8 8 8 0 8 8 8 0 8
8 4 6 4 8 0 8 0 0 0 8
8 0 4 0 8 0 8 0 8 8 8
8 0 0 0 8 1 8 0 0 0 8
8 0 0 0 8 8 8 0 9 0 8
8 0 0 0 0 3 0 0 0 0 8
8 8 8 8 8 8 8 8 8 8 8