17 12
8 8 8 8 8 8 8 8 8 8 8 8 8 8 8 8 8
8 0 0 0 8 0 0 0 0 0 0 0 8 0 0 0 8
8 0 9 0 3 0 0 0 0 0 0 0 8 0 6 0 8
8 0 0 0 8 0 0 0 0 0 0 0 4 0 0 0 8
8 8 8 8 8 0 0 0 0 0 0 0 8 8 8 8 8
8 8 8 8 8 8 0 0 0 0 0 8 8 8 8 8 8
8 8 8 8 8 8 8 0 0 0 8 8 8 8 8 8 8
8 8 8 8 8 8 8 8 0 8 8 8 8 8 8 8 8
8 0 1 0 8 8 8 8 0 8 8 8 8 8 8 8 8
8 0 0 0 8 8 8 0 0 0 8 8 8 8 8 8 8
8 0 0 0 0 0 0 0 0 0 0 0 0 0 0 7 8
8 8 8 8 8 8 8 8 8 8 8 8 8 8 8 8 8