12 11
8 8 8 8 8 8 8 8 8 8 8 8
8 1 0 0 0 0 0 0 0 0 0 8
8 8 8 8 8 8 8 8 0 0 0 8
8 0 0 0 0 0 0 0 0 0 0 8
8 0 0 0 8 8 8 8 8 8 8 8
8 0 0 0 0 0 0 0 0 0 0 8
8 8 8 8 8 8 8 8 0 0 0 8
8 0 0 0 0 0 0 0 0 0 0 8
8 0 0 0 8 8 8 8 8 8 8 8
8 0 0 0 0 0 0 0 0 0 6 8
8 8 8 8 8 8 8 8 8 8 8 8